SO ./textures/brick.xpm           
R 1000 1000
WE ./textures/wood.xpm
EA      ./textures/nnn.xpm
S          ./textures/cactus.xpm
NO./textures/eagle.xpm         

F 50, 60, 70
C 0, 100, 180     


1111
10S1
1001
1001
1001
1001
1001
1001
1001
1001
1001
1001
1001
1001
1001
1001
1001
1001
1001
1001
1001
1001
1001
1001
1001
1001
1001
1001
1001
1001
1001
1001
1001
1001
1001
1001
1001
1001
1001
1001
1001
1001
1001
1001
1001
1001
1001
1001
1001
1001
1001
1001
1001
1001
1001
1001
1001
1001
1001
1001
1001
1001
1001
1001
1001
1001
1001
1001
1001
1111
