










R     640  640





NO ./texture/wall_1.xpm         
SO ./texture/wall_2.xpm 
WE ./texture/wall_5.xpm 
EA ./texture/wall_3.xpm 
S          ./texture/cactus.xpm

               F         50   ,    60     ,          70



          C          22  ,   100        ,      180     




1111111111
1000000101
1000000101
10000000E1
1000000001
1000000001
1000000001
1111111111
































