R  23 23
F  10 12 13
C  11 12 13
WEwwwwwww.				
EA     eeeeeee.					
SO   ooooooo.					
NO 		nnnnnnn.					
S  				sssssss.					

		11111111111111111111
1111111110000000000000000001
1000000000000000000000000001
1000000000000000000000000001
1000000000000000000111111111
10000000000000000001
11111111111111111111
